	3097 3096 3098 3300 3094 3298 3299 3101 3102 3103 3105 3095 5098 5095 
	3232 3161 3162 3218 3219 3222 3233 3235 3237 3158 
	3004 3007 3010 3012 3016 3018 3020 3021 3022 3023 3024 3025 3026 3027 3029 3030 3031 3033 3035 3057 3059 3062 3067 3072 3074 
	3076 3078 3080 3086 3091 3093 3023 5099
	3228 3234 3240 
	3140 3144 3145 3150 3188
	3107 3116  3127 3130 3132 3133 3136 3186 3189 3272 3275 
	
	Usable colours of provinces no longer in use.
